106 61
...#######################################################################################################
...#..............#........#........#.....#..#....................#........#..............#.....#........#
#..####..#..####..#######..#######..#..####..###################..####..#######..##########..####..#..#..#
#..#..#..#..#...........#.....#..#...........#..#.....#...........#...........#.....#.....#.....#..#..#..#
#..#..####..##########..####..#..####..####..#..####..#######..#..#..#######..#..#######..#..##########..#
#.................#........#...........#........#.....#..#.....#.....#..#.....#...........#........#.....#
#..#######..##########..#..####..#..#######..####..####..#..#######..#..#..##########..##########..#..####
#..#.....#...........#..#........#..#..#....................#..#..#..#........#..............#..#.....#..#
#..#..#############..####..##########..#..#######..#..#######..#..####..#############..####..#..#..####..#
#..#.....#........#..#........#.....#........#.....#.....#.....#.....#.....#.....#........#..#...........#
####..#######..#..#..####..#######..#..#..#..#..#..#..#######..####..#..#..#..#######..####..####..#..####
#.....#........#..#.....#..#..#........#..#..#..#..#.....#..............#..#.....#........#.....#..#.....#
#..####..#..#..#############..#..####..####..#######..#############..####..#..####..################..####
#..#..#..#..#..#..#...........#..#.....#.....#..#..#.....#..#.....#..#....................#..............#
#..#..####..####..#..####..##########..#..#..#..#..#######..#..#######..#############..#..#..#############
#..#...........#.....#...........#..#..#..#..#..#.................#.....#..............#..#........#.....#
#..#..#..#######..#..####..#..#..#..####..####..#..####..####..#..####..#############..#######..#..#..####
#..#..#.....#..#..#..#..#..#..#.....#........#........#..#.....#..#.....#.....#..#........#.....#..#.....#
#..#..#..#..#..####..#..#..####..####..#######..#######..##########..#..#..#..#..#..#..#..####..####..####
#.....#..#..#..#.....#.....#........#.....#........#..#..#...........#..#..#..#.....#..#..#..#..#........#
#..#..#######..#..#..####..####..####..#######..####..################..#..####..##########..#..#..#..####
#..#...........#..#..#.....#..#..#..#....................#..#...........#...........#...........#..#..#..#
##########..#..#..##########..#..#..#..#..#..#############..##########..#######..#..####..#######..####..#
#..#........#.....#.....#..#.....#..#..#..#........#..#........#..#........#.....#.................#.....#
#..#..#######..#######..#..#..####..####..##########..####..#..#..#..####..######################..####..#
#.....#..#..#..#...........#..............#..#.....#..#..#..#..#..#.....#........#..#..#........#........#
#..####..#..#..#..####..#######..#..####..#..#..####..#..####..#..#..#############..#..#..####..#..####..#
#.....#..#........#..#........#..#..#..........................#..#..#..#.....#.....#..#..#...........#..#
#..#..#..####..#..#..##########..##########..#..####..#..####..#..#..#..####..####..#..#######..####..####
#..#..#........#..#.....#...........#.....#..#..#.....#.....#.....#.....#...........#...........#..#.....#
##########..####..#..#############..#..#..##########..#..################..#..####..#..####..####..####..#
#.....#..#..#..#..............#........#.....#.....#..#...........#.....#..#..#..#.....#..............#..#
#..#..#..####..#..#..#..#..#######..#..#######..#..#############..####..#######..#######..####..####..####
#..#.....#........#..#..#........#..#........#..#..............#..#........#..#........#..#.....#..#.....#
####..#..#..#######..#######..#..##########..#######..#..####..####..#..#..#..#..#..#..##########..#######
#.....#..#..#.....#..#.....#..#.....#..#..#........#..#.....#........#..#.....#..#..#.....#..#........#..#
#..#..####..####..#..####..#..#######..#..####..#######..##########..##########..#..#######..####..#..#..#
#..#........#..#.....#...........#..#.....#........#........#...........#..#..#..#........#.....#..#..#..#
#..#######..#..####..#######..#..#..#..#######..####..####..#..####..####..#..####..#..#..####..#..####..#
#.....#..#.....#.....#........#..#..#........#..#........#..#.....#..............#..#..#...........#.....#
####..#..####..##########..#..#..#..#..######################..#..#############..####..#..#..#..####..#..#
#..#..#.....#..#.....#.....#..#.....#..#....................#..#.....#..#..#..#..#.....#..#..#........#..#
#..#..#..##########..#######..#..####..####..#..####..####..#..#######..#..#..####..#..####..#############
#..#.....#.....#........#.....#.....#........#..#........#..#...........#.....#..#..#..#..#.....#..#..#..#
#..#..#..#..#..####..#..#######..#..######################..####..#..#######..#..####..#..####..#..#..#..#
#.....#.....#..#.....#..#.....#..#........#.................#.....#..............#........#..#..#..#.....#
#..####..#######..#..#######..#######..#..#######..####..#..#..#..####..#..##########..####..####..#..#..#
#..#..............#..#.....#.....#.....#.....#..#.....#..#.....#.....#..#..#.....#........#.....#.....#..#
#..##########..#..#######..####..##########..#..####..#..################..####..####..#######..####..#..#
#..#..#..#..#..#.....#..#..#..#.................#.....#.....#.....#.......................#.....#.....#..#
####..#..#..####..####..#..#..#..#######..#######..#######..#..####..#..#..##########..####..#..#..#######
#.....#........#..#..#..#........#..#.....#..............#..#.....#..#..#...........#..#.....#...........#
#..#..#..#######..#..#..#..#..#..#..#..##########..#..#..####..#..#..#..#######..####..#..#..#..#..#..#..#
#..#...........#........#..#..#.....#.....#.....#..#..#..#.....#.....#..#..#........#.....#..#..#..#..#..#
#..####..####..#..##########..#..#..####..#..#..####..##########..#..#..#..####..#######..#..#..####..#..#
#..#.....#..#..#...........#..#..#..#.....#..#..#........#.....#..#..#..#..#..#..#.....#..#..#..#.....#..#
####..####..#..####..#..#######..####..#######..#..####..####..####..####..#..#..#..####..####..#..#..#..#
#...........#..#..#..#.....#..#.....#.....#..#..#..#...........#.....#...........#..#........#..#..#..#..#
####..####..####..#..#..#..#..#..#..####..#..#..#..#..#######..#..##########..#..#..#..#############..#..#
#........#...........#..#..#.....#.....#...........#..#........#...........#..#.....#........#........#...
#######################################################################################################...
