151 101
...####################################################################################################################################################
...............#........#...........#.....#..#..#.....#....................#..#..#........#.....#..#......................................#...........#
#..####..#..#######..#..#..#############..#..#..#..####..#######..####..#..#..#..#..#..####..####..####..##########..#######..#######..####..####..####
#..#.....#..#.....#..#........#..#.....#..#...........#..#.....#..#.....#...........#..#....................#.....#..#..#........#..#.....#..#........#
####..####..#..#..#..#..####..#..####..#..#..#..####..#..#..####..####..####..#..##########..#######..#..#..#..#######..#..####..#..#..##########..####
#..#..#..#.....#..#..#..#.....#..#.....#..#..#..#.....#.....#.....#.....#.....#..#..#.....#..#........#..#........#.....#..#.....#........#..#........#
#..#..#..#..####..####..#..####..#..####..####..####..####..####..#..####..####..#..#..#..####..#############..#..#..##########..##########..#######..#
#.....#..#..#.....#.....#....................#..#........#.....#..#..#.....#..#..#.....#..#........#...........#..#..#.....#.....#........#..#........#
#######..####..#..#..#..################..#..#######..#######..#######..####..#..#..#############..####..##########..#..##########..#######..####..#..#
#.....#..#.....#..#..#.....#..#..#..#.....#..#........#........#.....#........#..#........#........#.................#..#..#........#.....#........#..#
#..#..#..#######..#..####..#..#..#..#..####..#..####..#######..#..#..####..#..#..#..#..#######..####..####..#..#######..#..#..####..#..####..#..####..#
#..#........#..#.....#...........#.....#.....#..#..............#..#..#.....#..#..#..#.....#..#.....#.....#..#.....#.....#........#...........#..#.....#
####..#######..####..#######..##########..#..##########..####..#..###################..####..#..#######..#..##########..#..#..#######..#######..####..#
#...........#...........#.....#..#........#.....#.....#.....#..#........#.....#..#....................#..#........#........#........#..#.....#..#.....#
#######..####..####..#..#######..####..#..#..#######..#..#######..#..####..####..#..#..#..################..####..####..#######..#######..#..##########
#..#...........#.....#..#..#.....#.....#..#..#.................#..#.................#..#..#...........#........#...........#.....#........#.....#..#..#
#..#..#######..#######..#..#..#############..#######..#############..##########..#..#..####..####..####..#..#######..################..####..#..#..#..#
#..#.....#..#.....#..#.....#........#..#.....#..#.....#........#..#..#..#..#.....#..#..#........#..#..#..#..#..#.....#...........#........#..#.....#..#
#..####..#..#..####..#..#..####..####..#..####..####..#..#..#..#..#..#..#..####..####..#..#######..#..#######..####..#..##########..#..#######..#..#..#
#.....#.....#.....#.....#..#........#..#..#..............#..#........#.....#........#..#..#..............#..#........#.....#..#..#..#........#..#.....#
#..#############..#..#..####..####..#..#############..################..#..#..#..###################..####..#..#######..####..#..#..################..#
#.....#..#........#..#.....#.....#.....#........#..............#........#.....#...........#..............#.....#.....#........#..#..#........#........#
#..####..################..#..####..#######..#..#..#############..#..#..####..#..####..####..#######..#..####..#..####..#######..#..#######..####..#..#
#.....#.....#.....#..#..#.....#..#..#.....#..#..#...........#..#..#..#..#..#..#..#........#..#.....#..#..#.......................#...........#.....#..#
#..#######..####..#..#..#..####..####..#..#..#..####..#######..#######..#..#..##########..####..#..#..#############..####..#..##########..#..#..#..####
#........#.....#.....#...........#.....#..#..#..#.....#...........#..#.....#........#..#.....#..#.....#.....#..#.....#.....#.....#.....#..#..#..#.....#
#..#..#..#..####..##########..####..####..#..##########..#######..#..####..##########..#############..#..####..####..####..#..####..#..#..#############
#..#..#...........#...........#..#..#..#.....#...........#.....#.....#..............#...........#........#.....#.....#..#..#.....#..#........#........#
####..##########..#..####..####..#..#..#######..#######..#..#..#..#..#..################..#..####..##########..#..####..####..#..#######..####..#..####
#...........#..#........#..#.....#..............#...........#..#..#..#.....#..............#..#..#........#.....#..#..#........#..#...........#..#..#..#
#..##########..##########..####..#..#######..#######..####..#..####..#############..#######..#..#..####..####..####..#######..#..####..####..####..#..#
#.....#........#..#.................#...........#........#..#.....#..#..#..#..............#...........#...........#..#........#.....#..#..............#
#..##########..#..#############..####..#..######################..####..#..#..####..#######..#..####..##########..#..##########..##########..#..#######
#..#..#.....#.....#..#...........#..#..#..............#.....#........#........#..#........#..#..#.....#.....#................................#........#
####..#..####..#..#..##########..#..#######..#..#..#######..##########..####..#..####..################..####..#############..#############..#######..#
#..............#........#..#...........#.....#..#...........#...........#..#.....#...........#..#...........#........#..#........#........#..#........#
##########..##########..#..####..#..####..#..################..####..#..#..#..################..#..#..#..#######..####..#..####..#..#..#..#######..####
#........#..#....................#.....#..#........#...........#.....#..#..............#...........#..#..#..#..#.....#.....#..#.....#..#..#........#..#
#..#..#..#######..###################..####..#..#..#######..#######..####..#############..#############..#..#..####..#..#..#..#..####..####..####..#..#
#..#..#...........#.....#..............#.....#..#.................#..#...........#.....#..#.....#.....#.....#..#.....#..#.....#..#..#.....#.....#.....#
#..##########..#..####..#..####..##########..#######..################..#######..####..#..#..#######..#..####..#..#..##########..#..####..####..#######
#..#..#.....#..#........#..#.....#..#..#.....#.....#..#........#..#........#...........#..#.....#........#..#..#..#..#.....#.....#.....#..#..#..#.....#
#..#..#..####..####..##########..#..#..####..#..##########..####..#..#######..#..#..#..####..####..#######..#..#..#######..####..####..####..####..#..#
#..#..#.....#.....#..#........#.....#...........#........#..#..#...........#..#..#..#.....#.....#..#........#.....#..#..#.....#..#........#.....#..#..#
#..#..#..#..#..#..#..####..#######..####..#######..#######..#..##########..#..#######..####..####..#..##########..#..#..####..#..#..#######..#######..#
#..#.....#..#..#..#.....#..#.....#..#.....#........#.....#..#........#..#..#.....#..#.....#..#..#..............#..#........#.................#..#.....#
####..#..#..#..#######..#..####..#######..#..####..#..####..#..####..#..#..####..#..#######..#..#######..##########..###################..####..####..#
#.....#..#..#..#.....#..#..#.................#...........#........#..#.....#.....#........#..#..#..............#.....#..#..#........#..#...........#..#
##########..#..#..#######..####..####..#..#############..#######..####..#..#..#..#..#######..#..#######..####..#..####..#..#..#######..####..####..#..#
#..............#..#..#..............#..#.....#........#...........#.....#..#..#..............#........#..#.....#..#...........#..#..............#.....#
####..####..#..#..#..#######..#######..#######..######################..#..##########..#######..#..#..#..#######..#..#######..#..#######..#######..#..#
#.....#.....#...........#..#.....#..#.................#........#..#.....#..#..#.....#...........#..#..#...........#.....#........#..#...........#..#..#
#..#############..#######..#######..####..#..#######..#..####..#..#######..#..#..#..#..#############..#..#..#..#######..#######..#..#######..#######..#
#.....#..#..#..............#........#..#..#..#........#..#..#..#........#........#..#.....#.....#..#..#..#..#..#........#..#.....#..#.....#..#.....#..#
#..####..#..#######..####..#..#######..####..#######..#..#..####..#..#..#######..#############..#..#..#..####..#######..#..####..#..#..##########..#..#
#........#........#..#.....#.....#..#..#..#.....#..#.....#..#.....#..#..#.....#.....#....................#..............#..#..#..#........#...........#
#######..#######..#######..#..#..#..#..#..####..#..#######..#######..####..#..#######..#..#######..####..#..#######..####..#..####..#######..####..#..#
#..#..#..#..#...........#..#..#........#.....#........#........#........#..#.....#.....#.....#........#..#.....#..#........#.....#.....#..#..#.....#..#
#..#..#..#..#..#######..#..#######..####..####..#######..####..#..####..####..####..#..#..####..####..#..#..#..#..#######..#..#..####..#..##########..#
#.....#.....#........#.....#..#..#..#.....#........#........#..#..#..#..#..#.....#..#..#..#.....#..#..#..#..#..#.....#........#........#.....#.....#..#
#..######################..#..#..#..####..####..#######..#..####..#..####..####..#######..#..####..####..#..####..#######..#..#######..#..#..#..#######
#.............................#...........#.....#.....#..#..#.....#..#..#..............#..#..#........#..#.....#........#..#..#........#..#........#..#
####..#..#..####..####..####..#..#..#..#..#######..#..#..#######..#..#..##########..##########..#..##########..####..#######..#..####..#..#..#..####..#
#.....#..#.....#..#..#.....#..#..#..#..#.....#..#..#..#..............#.....#........#........#..#........#...........#........#.....#.....#..#..#.....#
####..#######..####..#..##########..##########..####..####..#..#######..##########..#######..#..#..#..#######..#..#..##########..#######..#######..#..#
#........#.....#.....#..#..............#..#...........#..#..#..............#.....#........#.....#..#..#.....#..#..#........#.....#..#..#.....#.....#..#
#######..#..####..################..####..####..#..#..#..#######..#..##########..#..#..####..#######..#..#..####..####..##########..#..#######..#######
#..#.....#.....#..#..#..............#..#........#..#..#..#........#.................#.....#..#...........#.....#..#...........#..#.....#..#........#..#
#..##########..#..#..####..####..#..#..####..#..#..####..##########..####..#..####..##########..####..##########..#..##########..#..####..#..#######..#
#...........#..............#.....#...........#..#..#..#..............#.....#..#........#..#.....#..#..#..#.....#..#..#.....#..#..#........#........#..#
#..#..####..#..#######..#######..#..##########..#..#..####..####..#..####..####..#######..#..#..#..####..#..#..#..#..####..#..#..#######..#..#######..#
#..#.....#...........#.....#.....#..#.....#.....#........#..#..#..#..#........#.....#..#.....#........#.....#.....#.....#.....#..#....................#
####..#######..#..#############..####..#..#..#..#######..#..#..#..####..#..####..#..#..#..####..####..####..####..#..#..####..#..####..####..#..#..####
#........#.....#...........#.....#..#..#.....#.....#..#.....#........#..#..#..#..#..#..#.....#..#..#..#........#..#..#..#..#........#.....#..#..#.....#
#..#..####..#######..#######..####..#..#..####..####..####..#..#######..#..#..#..####..##########..#..####..#..#..#..####..#..####..####..##########..#
#..#.....#........#........#.....#.....#.....#..#..#........#..#.....#..#.....#..#.......................#..#..#..#.....#........#.....#.....#........#
####..#..#############..################..#..####..#..#######..#..####..###################..#######..####..####..#######..#############..##########..#
#.....#..#..............#.....#........#..#..#..............#..#..............#..#........#..#.....#..#..#.....#.....#..#..#...........#........#.....#
####..####..#..#..#..#######..####..#..##########..####..#..#..#######..#######..#..#######..#..####..#..#..#######..#..#..####..#######..####..#######
#.....#.....#..#..#..#..............#...........#.....#..#..#..#..#..#..#........#........#.....#..#........#.....#..#........#...........#..#..#..#..#
#..#..#######..##########..#..#..#######..##########..#..#######..#..#..#..#######..#..#..####..#..#..#..####..#..#..#######..#######..#..#..####..#..#
#..#.....#..#..#.....#.....#..#..#.....#.....#........#..#..#..#..............#..#..#..#.....#.....#..#.....#..#....................#..#..#..#.....#..#
#..#######..#..####..#######..####..####..#..####..####..#..#..#######..#######..#..####..#..#..#..##########..#..####..#..####..#..####..#..####..#..#
#.....#.....#..#..#.....#..............#..#..#.....#.....#..#..#...........#.....#..#..#..#..#..#.....#........#.....#..#.....#..#..............#..#..#
#..####..#######..####..#######..####..####..##########..#..#..##########..#..####..#..#######..##########..#############..#..####..#######..####..#..#
#.....#..#........#..#...........#.....#........#..............#.....#..#..#........#........#..#..#.....#........#........#.....#..#.................#
#..#..#..####..####..#..####..#..####..####..#..################..#..#..#..####..#..#..#..#######..####..####..####..#..#..#############..####..#######
#..#........#..#.....#..#.....#..#..#..#..#..#..#..#.....#.....#..#........#..#..#..#..#..#.................#..#.....#..#..#...........#..#...........#
#############..####..#..####..#..#..####..#######..#..#..#..#..####..#######..#..#..#..####..#######..#######..#..####..##########..#..####..####..####
#.....#....................#..#..#..#.....#..#........#.....#.....#.....#........#........#..#.....#...........#.....#...........#..#.....#..#........#
####..####..#..#..##########..####..#..####..####..#######..####..#..#..##########..####..#..#..#..#..####..#..#..#..##########..#######..#..#..#######
#.....#.....#..#...........#..#..#........#..............#.....#.....#..#........#.....#........#..#..#..#..#..#..#.....#.....#..#..#.....#..#.....#..#
#..#######..####..#..##########..####..#..#..#######..#..#######..#######..#..#############..#..#..####..####..####..#..#..#..####..#..####..#..#..#..#
#..#...........#..#.....#.....#..#.....#.....#..#.....#..#..#...........#..#..#..#.....#.....#..#..#...........#..#..#..#..#...........#.....#..#.....#
#..#..####..#######..####..####..#..#..#..####..#..#######..#..#..####..####..#..#..####..####..################..#######..####..#..#..####..##########
#..#..#...........#..#.....#........#..#..#..#.....#..#..#.....#.....#.....#..#.....#........#..#.....#..#..#........#.....#..#..#..#...........#.....#
#..####..#..##########..################..#..####..#..#..#..#######..####..#..#..####..#..#..#######..#..#..#..#..#..#..####..#..####..##########..#..#
#.....#..#..#..#........#.....#........#........#........#........#..#.....#.....#.....#..#..#..#...........#..#..#........#.....#...........#.....#..#
#..####..#..#..#######..#..##########..#..#..#..####..#..##########..#..#######..#..#######..#..#..####..#######..####..#..#..#..####..#..#..#..####..#
#........#................................#..#..#.....#.....#........#.....#...........#........#.....#...........#.....#..#..#..#.....#..#........#...
####################################################################################################################################################...
