240 58
................................................................................................................%%%%%%%%%%%%%%%%%%%%%%%.........................................................................................................
......................................................................................................$$$$$$$$$$)%%%%%%%%%%%%%%%%%%%%%%/$$$$$$$$$...............................................................................................
.............................................................................................$$$$$%%%%%%%////////////////////////////////////////%%%%)$$$$$.....................................................................................
......................................................................................$$$$)))%%%%%%%%%%%//////////////////////////////////////////////%%%%%)))$$$...............................................................................
..................................................................................$$$$$$=)%%%%%%%%%%%%%////////////////////////////////////////////////////%%%)=/$$$$$$.........................................................................
..............................................................................$$$$$$$$$$$////))))%%%%///////////////////////////////////////////////%%%%%%%==========//$$$......................................................................
.........................................................................$$$$$$$$$$$$$$$$$$$$$$$$////%%%%//////////////////////////////////////%%%%======================//$$$..................................................................
......................................................................$$$$$$$$$$$$$$$$$$$$$$$$$$$$//====)))))))))))%%%%%%%%%%%%%%%%%)))))))))))======================//////////$$$..............................................................
....................................................................$$$$$$$$$$$$$$$$$$$$$$$$$$$$//==============================================================///////////======/$$$...........................................................
.................................................................$$$$$$$$$$$$$$$$$$$$$$$$$$$$$$$============================================================/////////===========)))=/$$.........................................................
..............................................................$$$$$$$$$$$$$$$$$$$$$$$$$$$$$$$$$$////////////==============================///////////////////================)))))))))=/$$......................................................
............................................................$$$$$$$$$$$$$$$$$$$$$$$$$$$$$$$$$===/////////////////////////////////////////////////////===================)))))))))))))))))=/$....................................................
.........................................................$$$////$$$$$$$$$$$$$$$$$$$$$$$$$$///==============================================)======================)))))))))))))))))))))))))/$$$.................................................
.......................................................$$/=======//$$$$$$$$$$$$$$$$$$///====================================================================)))))))))))))))))))))))))))))))))=/$$...............................................
......................................................$$===============//$$$$$$$$$/==))))))))))))))))))))))))===============================))))))))))))))))))))))))))))))))))))))))))))))))))))$$..............................................
.....................................................$/===================///$$/==)))))))))))))))))))))))))))))))))))))))))))))))))))))))))))))))))))))))))))))))))))))))))))))))))))))))))))))))=$$............................................
....................................................$$$$$$$=====================)))))))))))))))))))))))))))))))))))))))))))))))))))))))))))))))))))))))))))))))))))))))))))))))))))))))))))))))))=$$............................................
..................................................$$$$$$$$$$$$$$$$$==========))))))))))))))))))))))))))))))))))))))))))))))))))))))))))))))))))))))))))))))))))))))))))))))))))))))))))))=////$$$$$$$$..........................................
.................................................$$$$$$$$$$$$$$$$$$$$$$$///===))))))))))))))))))))))))))))))))))))))))))))))))))))))))))))))))))))))))))))))))))))))))))))))))======/$$$$$$$$$////===/$.........................................
................................................$$$$$$$$$$$$$$$$$$$$$$$$$$$$$$$$$$$$/========)))))))))))))))))))))))))))))))))))))))))))))))))))))))))))))))))))========$$$$$$$$$$$$$$$////===========$$........................................
...............................................$$$$$$$$$$$$$$$$$$$$$$$$$$$$$$$$$$$$$$$$$$$$$$//////////////=)))))))))))))))))))))))))))))))))))))//////////////$$$$$$$$$$$$///////======================$.......................................
.............................................$$$$$$$$$$$$$$$$$$$$$$$$$$$$/=====/$$$$$$$$$$$$$$$$$$$$$$$$$$$$$$$$$$$$$$$$$$$$$$$$$$$$$$$$$$$$$$$$$$$$$$$$$$$$$$$$$$$$/===================================$$......................................
...................................$$$$$$$$$$$$$$$$$$$$$$$$$$$$$$$$$$$//==================/////////////$$$$$$$$$$$$$$$$$$$$$$$$$$$$$$$$$$$$$$$/////////////==============================================/$$$$..................................
.....................$$$$$$$$/)%%%%%/////////%$$$$$$$$$$$$$$$$$$$$$$$/===================================================================================================================================)///%%%%%%%%$$$$$$.....................
..................$$=%////////%///////%%%%%%%%/////$$$$$$$$$$$$$$$$//==========================================================================================================================)))))))))))%///////////////)==$$$$...............
..............$///%///%%%%%%%//////////%%%%%/////////////////////$/===========================================================================================================)))))))))))))))))))))))))))))%///////////////%%///%/$.............
.........$$=%%%%%%%%////%%%%%%%%%%%%%%%%%%%%$$$$$$$$$$$//////////==)))))))))))))))))))))))))))))=================================================)))))))))))))))))))))))))))))))))))))))))))))==========///)/%%%%%%%%%%%%%%%/////%%%%=$$........
......$$=%%//////////%%%%%))))))))))))=$$$$$//$$$$$$$$$$$$$$$$$$$/////======================))))))))))))))))))))))))))))))))))))))))))))))))))))))))))))))======================//////////////===========)))%%%%%%%%%%%%%%%%%/////////%%)$$.....
......$/%%///////////%%%%%$$$$$$$$$$$$$...../////////////////////=))))=====================////////////////////////////////////////////////////////////////=====================)))))))))))))))))))))))))))$...$$$$$$$$$$$$$/%%////////%%//.....
......$/%%%///////////%%%%%%%%%%%%%%%%%/$$$$=))))))))))))))))))))%%%))))))))))))))))))))))))))))))))))))))))))))))))))))))))))))))))))))))))))))))))))))))))))))))))))))))))))))))%%%%%%%%%%%%%%%%%%%%%%%%%)//=/////////////%%////////%%%/$.....
........$$=%%%%///%//////%%%%%%%%%%%%%%%%%%%%%%%%%%%%%%%%%%%%%%%%%%%/////////////////////%%%%%%%%%%%%%%%%%%%%%%%%%%%%%%%%%%%%%%%%%%%%%%%%%%%%%%%%%%%%%%%%%%%%/////////////////////%%%%%%%%%%%%%%%%%%%%%%%%%%%%%%%%%////////////////%%%=$$.......
...........$$$$))))%%%%///%%%/////%%%%%%%%%%%%%%%%%%%%%%%%%%%%%%%%%%%%%%%%%%%%%%%%%%%%%%%%////////%%%%%%%%%%%%/////////////%%%%%%%%%%////%%%%%%%%///////////%%%%%%%%%%%%%%%%%%%%%%%%%%%%%///////////%////////////////////////%))))$$$$..........
...................$$$$%%%%%%%%%%%%%////////////////%%%%%%%%%%%%%%%%%%%%%%%%%%%%%%%%%%%%%%%%%%%%%%%%%%%%%%%%%%%%%%%%%%%%%%%%%/////////////////////%%%%%%%%%%%%%%%////////%%////////////////////////////////////////%%%%%%%$$$$..................
.............................$//////%%%%%%%%%%%%%%%%%%%//%%%%%%%%%%%%%%%%%%%%%%%%%%%%%%%%%%%%%%%%%%%%%%%%%%%%%%%%%%%%%%%%%%%%%%%%%%%%%%%%%%%%%%%%%%%%%%%%%%%/////////////////////////////////////////%%%%%%%%=/////$............................
....................................$$$$$$$$$$)))))))))%%%%%%%%%%%%%%%%%%%%%%%%%%%%%%%%%%%%%%%%%%%%%%%%%%%%%%%%%%%%%%%%%%%%%%%%%%%%%%%%%%%%%%%%%%%%%%%//%%///////////////////////////////%)))))))))))$$$$$$$$...................................
.............................................$$$$$$$$$$$$$$$$$$$$$$$=%%%%%%%%%%%%%%%%%%%%%%%%%%%%%%%%%%%%%%%%%%%%%%%%%%%%%%%%%%%%%%%%%%%%%%%%%%%%%%%%%%%%%%%%%%%%%%%%%%%%%%%)$$$$$$$$$$$$$$$$$$$$$$$$$$$$$......................................
..............................................$$$$$$$$$$$$$$$$$$$$$$$$$$$$$$$$$$$$$$$$$$$$/////////////////////////////////////////////////////////////$$$$$$$$$$$$$$$$$$$$$$$$$$$$$$$$$$$$$$$$$$$$$$$$$$$......................................
...............................................$$$$$$$$$$$$$$$$$$$$$$$$$$$$$$$$$$$$$$$$$$$$$$$$$$$$$$$$$$$$$$$$$$$$$$$$$$$$$$$$$$$$$$$$$$$$$$$$$$$$$$$$$$$$$$$$$$$$$$$$$$$$$$$$$$$$$$$$$$$$$$$$$$$$$$$$$$.......................................
................................................$$$$$$$$$$$$$$$$$$$$$$$$$$$$$$$$$$$$$$$$$$$$$$$$$$$$$$$$$$$$$$$$$$$$$$$$$$$$$$$$$$$$$$$$$$$$$$$$$$$$$$$$$$$$$$$$$$$$$$$$$$$$$$$$$$$$$$$$$$$$$$$$$$$$$$$.........................................
.................................................$$$$$$$$$$$$$$$$$$$$$$$$$$$$$$$$$$$$$$$$$$$$$$$$$$$$$$$$$$$$$$$$$$$$$$$$$$$$$$$$$$$$$$$$$$$$$$$$$$$$$$$$$$$$$$$$$$$$$$$$$$$$$$$$$$$$$$$$$$$$$$$$$$$$$$.........................................
..................................................$$$$$$$$$$$$$$$$$$$$$$$$$$$$$$$$$$$$$$$$$$$$$$$$$$$$$$$$$$$$$$$$$$$$$$$$$$$$$$$$$$$$$$$$$$$$$$$$$$$$$$$$$$$$$$$$$$$$$$$$$$$$$$$$$$$$$$$$$$$$$$$$$$$...........................................
....................................................$$$$$$$$$$$$$$$$$$$$$$$$$$$$$$$$$$$$$$$$$$$$$$$$$$$$$$$$$$$$$$$$$$$$$$$$$$$$$$$$$$$$$$$$$$$$$$$$$$$$$$$$$$$$$$$$$$$$$$$$$$$$$$$$$$$$$$$$$$$$$$$$............................................
.....................................................$$$$$$$$$$$$$$$$$$$$$$$$$$$$$$$$$$$$$$$$$$$$$$$$$$$$$$$$$$$$$$$$$$$$$$$$$$$$$$$$$$$$$$$$$$$$$$$$$$$$$$$$$$$$$$$$$$$$$$$$$$$$$$$$$$$$$$$$$$$$$..............................................
......................................................$$$$$$$$$$$/////////////////////$$$$$$$$$$$$$$$$$$$$$$$$$$$$$$$$$$$$$$$$$$$$$$$$$$$$$$$$$$$$$$$$$$$$$$$$$$$$$////////////////////////====/$$..............................................
.......................................................$$$$$$$$$$//==========================================================================================================================/$$................................................
..........................................................$$$/$$$$//=======================================================================================================================$$...................................................
............................................................$$$$$$$$///==================================================================================================================/$$....................................................
..............................................................$$$////////==))))))))))============================================================================))))))))))))))))))))=//$$......................................................
.................................................................$$$$$//////==)))))))))))))))))))))))))))))))))))))))))))))))))))))))))))))))))))))))))))))))))))))))))))))))))))))=/$$.........................................................
......................................................................$$///////=))))))))))))))))))))))))))))))))))))))))))))))))))))))))))))))))))))))))))))))))))))))))))))))))=/$$............................................................
.......................................................................$$$$$$$$$//=)))))))))))))))))))))))))))))))))))))))))))))))))))))))))))))))))))))))))))))))))))))))))))/$$...............................................................
.........................................................................$$$$$$$$$$/=))))))))))))))))))%%%%%%%%%%%%%%%%%%%%%%%%%%%%%%%%%%%%%%%)))))))))))))))))))))))))))=/$$$..................................................................
..............................................................................$$$$$$//=)))))))))%%%%%%%%%%%%%%%%%%%%%%%%%%%%%%%%%%%%%%%%%%%%%%%%%%%%%)))))))))))))))===/$$......................................................................
...................................................................................$$$/==)%%%%%%%%%%%%%%%%%%%%%%%%%%%%%%%%%%%%%%%%%%%%%%%%%%%%%%%%%%%%%%%%%)))===$$$$...........................................................................
.......................................................................................$$$//=%%%%%%%%%%%%%%%%%%%%%%%%%%%%%%%%%%%%%%%%%%%%%%%%%%%%%%%%%%%%%)///$$$...............................................................................
.............................................................................................$$$$$====)%%%%%%//////////////////////////%%%%%%%%%%====/$$$$$.....................................................................................
......................................................................................................$$)%%%%%%%%%%%%%%%%%%%%%%%%%%%%%%%%%%%$$$$$...............................................................................................
................................................................................................................................................................................................................................................
