1300 105 105 105
1300 105 105 105
1300 105 105 105
0004 105 105 105 1291 058 055 074 0005 105 105 105
0004 105 105 105 0003 058 055 074 1285 025 025 112 0003 044 041 056 0005 105 105 105
0004 105 105 105 0003 058 055 074 1285 025 025 112 0003 044 041 056 0005 105 105 105
0004 105 105 105 0003 058 055 074 1285 025 025 112 0003 044 041 056 0005 105 105 105
0004 105 105 105 0003 058 055 074 1285 025 025 112 0003 044 041 056 0005 105 105 105
0004 105 105 105 0003 058 055 074 1285 025 025 112 0003 044 041 056 0005 105 105 105
0004 105 105 105 0003 058 055 074 1285 025 025 112 0003 044 041 056 0005 105 105 105
0004 105 105 105 0003 058 055 074 1285 025 025 112 0003 044 041 056 0005 105 105 105
0004 105 105 105 0003 058 055 074 1285 025 025 112 0003 044 041 056 0005 105 105 105
0004 105 105 105 0003 058 055 074 1285 025 025 112 0003 044 041 056 0005 105 105 105
0004 105 105 105 0003 058 055 074 1285 025 025 112 0003 044 041 056 0005 105 105 105
0004 105 105 105 0003 058 055 074 1285 025 025 112 0003 044 041 056 0005 105 105 105
0004 105 105 105 0003 058 055 074 1285 025 025 112 0003 044 041 056 0005 105 105 105
0004 105 105 105 0003 058 055 074 1285 025 025 112 0003 044 041 056 0005 105 105 105
0004 105 105 105 0003 058 055 074 1285 025 025 112 0003 044 041 056 0005 105 105 105
0004 105 105 105 0003 058 055 074 1285 025 025 112 0003 044 041 056 0005 105 105 105
0004 105 105 105 0003 058 055 074 1285 025 025 112 0003 044 041 056 0005 105 105 105
0004 105 105 105 0003 058 055 074 1285 025 025 112 0003 044 041 056 0005 105 105 105
0004 105 105 105 0003 058 055 074 1285 025 025 112 0003 044 041 056 0005 105 105 105
0004 105 105 105 0003 058 055 074 1285 025 025 112 0003 044 041 056 0005 105 105 105
0004 105 105 105 0003 058 055 074 1285 025 025 112 0003 044 041 056 0005 105 105 105
0004 105 105 105 0003 058 055 074 1285 025 025 112 0003 044 041 056 0005 105 105 105
0004 105 105 105 0003 058 055 074 1285 025 025 112 0003 044 041 056 0005 105 105 105
0004 105 105 105 0003 058 055 074 1285 025 025 112 0003 044 041 056 0005 105 105 105
0004 105 105 105 0003 058 055 074 1285 025 025 112 0003 044 041 056 0005 105 105 105
0004 105 105 105 0003 058 055 074 1285 025 025 112 0003 044 041 056 0005 105 105 105
0004 105 105 105 0003 058 055 074 1285 025 025 112 0003 044 041 056 0005 105 105 105
0004 105 105 105 0003 058 055 074 1285 025 025 112 0003 044 041 056 0005 105 105 105
0004 105 105 105 0003 058 055 074 1285 025 025 112 0003 044 041 056 0005 105 105 105
0004 105 105 105 0003 058 055 074 1285 025 025 112 0003 044 041 056 0005 105 105 105
0004 105 105 105 0003 058 055 074 1285 025 025 112 0003 044 041 056 0005 105 105 105
0004 105 105 105 0003 058 055 074 1285 025 025 112 0003 044 041 056 0005 105 105 105
0004 105 105 105 0003 058 055 074 1285 025 025 112 0003 044 041 056 0005 105 105 105
0004 105 105 105 0003 058 055 074 1285 025 025 112 0003 044 041 056 0005 105 105 105
0004 105 105 105 0003 058 055 074 1285 025 025 112 0003 044 041 056 0005 105 105 105
0004 105 105 105 0003 058 055 074 1285 025 025 112 0003 044 041 056 0005 105 105 105
0004 105 105 105 0003 058 055 074 1285 025 025 112 0003 044 041 056 0005 105 105 105
0004 105 105 105 0003 058 055 074 1285 025 025 112 0003 044 041 056 0005 105 105 105
0004 105 105 105 0003 058 055 074 1285 025 025 112 0003 044 041 056 0005 105 105 105
0004 105 105 105 0003 058 055 074 1285 025 025 112 0003 044 041 056 0005 105 105 105
0004 105 105 105 0003 058 055 074 1285 025 025 112 0003 044 041 056 0005 105 105 105
0004 105 105 105 0003 058 055 074 1285 025 025 112 0003 044 041 056 0005 105 105 105
0004 105 105 105 0003 058 055 074 1285 025 025 112 0003 044 041 056 0005 105 105 105
0004 105 105 105 0003 058 055 074 1285 025 025 112 0003 044 041 056 0005 105 105 105
0004 105 105 105 0003 058 055 074 1285 025 025 112 0003 044 041 056 0005 105 105 105
0004 105 105 105 0003 058 055 074 1285 025 025 112 0003 044 041 056 0005 105 105 105
0004 105 105 105 0003 058 055 074 1285 025 025 112 0003 044 041 056 0005 105 105 105
0004 105 105 105 0003 058 055 074 1285 025 025 112 0003 044 041 056 0005 105 105 105
0004 105 105 105 0003 058 055 074 1285 025 025 112 0003 044 041 056 0005 105 105 105
0004 105 105 105 0003 058 055 074 1285 025 025 112 0003 044 041 056 0005 105 105 105
0004 105 105 105 0003 058 055 074 1285 025 025 112 0003 044 041 056 0005 105 105 105
0004 105 105 105 0003 058 055 074 1285 025 025 112 0003 044 041 056 0005 105 105 105
0004 105 105 105 0003 058 055 074 1285 025 025 112 0003 044 041 056 0005 105 105 105
0004 105 105 105 0003 058 055 074 1285 025 025 112 0003 044 041 056 0005 105 105 105
0004 105 105 105 0003 058 055 074 1285 025 025 112 0003 044 041 056 0005 105 105 105
0004 105 105 105 0003 058 055 074 1285 025 025 112 0003 044 041 056 0005 105 105 105
0004 105 105 105 0003 058 055 074 1285 025 025 112 0003 044 041 056 0005 105 105 105
0004 105 105 105 0003 058 055 074 1285 025 025 112 0003 044 041 056 0005 105 105 105
0004 105 105 105 0003 058 055 074 1285 025 025 112 0003 044 041 056 0005 105 105 105
0004 105 105 105 0003 058 055 074 1285 025 025 112 0003 044 041 056 0005 105 105 105
0004 105 105 105 0003 058 055 074 1285 025 025 112 0003 044 041 056 0005 105 105 105
0004 105 105 105 0003 058 055 074 1285 025 025 112 0003 044 041 056 0005 105 105 105
0004 105 105 105 0003 058 055 074 1285 025 025 112 0003 044 041 056 0005 105 105 105
0004 105 105 105 0003 058 055 074 1285 025 025 112 0003 044 041 056 0005 105 105 105
0004 105 105 105 0003 058 055 074 1285 025 025 112 0003 044 041 056 0005 105 105 105
0004 105 105 105 0003 058 055 074 1285 025 025 112 0003 044 041 056 0005 105 105 105
0004 105 105 105 0003 058 055 074 1285 025 025 112 0003 044 041 056 0005 105 105 105
0004 105 105 105 0003 058 055 074 1285 025 025 112 0003 044 041 056 0005 105 105 105
0004 105 105 105 0003 058 055 074 1285 025 025 112 0003 044 041 056 0005 105 105 105
0004 105 105 105 0003 058 055 074 1285 025 025 112 0003 044 041 056 0005 105 105 105
0004 105 105 105 0003 058 055 074 1285 025 025 112 0003 044 041 056 0005 105 105 105
0004 105 105 105 0003 058 055 074 1285 025 025 112 0003 044 041 056 0005 105 105 105
0004 105 105 105 0003 058 055 074 1285 025 025 112 0003 044 041 056 0005 105 105 105
0004 105 105 105 0003 058 055 074 1285 025 025 112 0003 044 041 056 0005 105 105 105
0004 105 105 105 0003 058 055 074 1285 025 025 112 0003 044 041 056 0005 105 105 105
0004 105 105 105 0003 058 055 074 1285 025 025 112 0003 044 041 056 0005 105 105 105
0004 105 105 105 0003 058 055 074 1285 025 025 112 0003 044 041 056 0005 105 105 105
0004 105 105 105 0003 058 055 074 1285 025 025 112 0003 044 041 056 0005 105 105 105
0004 105 105 105 0003 058 055 074 1285 025 025 112 0003 044 041 056 0005 105 105 105
0004 105 105 105 0003 058 055 074 1285 025 025 112 0003 044 041 056 0005 105 105 105
0004 105 105 105 0003 058 055 074 1285 025 025 112 0003 044 041 056 0005 105 105 105
0004 105 105 105 0003 058 055 074 1285 025 025 112 0003 044 041 056 0005 105 105 105
0004 105 105 105 0003 058 055 074 1285 025 025 112 0003 044 041 056 0005 105 105 105
0004 105 105 105 0003 058 055 074 1285 025 025 112 0003 044 041 056 0005 105 105 105
0004 105 105 105 0003 058 055 074 1285 025 025 112 0003 044 041 056 0005 105 105 105
0004 105 105 105 0003 058 055 074 1285 025 025 112 0003 044 041 056 0005 105 105 105
0004 105 105 105 0003 058 055 074 1285 025 025 112 0003 044 041 056 0005 105 105 105
0004 105 105 105 0003 058 055 074 1285 025 025 112 0003 044 041 056 0005 105 105 105
0004 105 105 105 0003 058 055 074 1285 025 025 112 0003 044 041 056 0005 105 105 105
0004 105 105 105 0003 058 055 074 1285 025 025 112 0003 044 041 056 0005 105 105 105
0004 105 105 105 0003 058 055 074 1285 025 025 112 0003 044 041 056 0005 105 105 105
0004 105 105 105 0003 058 055 074 1285 025 025 112 0003 044 041 056 0005 105 105 105
0004 105 105 105 0003 058 055 074 1285 025 025 112 0003 044 041 056 0005 105 105 105
0004 105 105 105 0003 058 055 074 1285 025 025 112 0003 044 041 056 0005 105 105 105
0004 105 105 105 0003 058 055 074 1285 025 025 112 0003 044 041 056 0005 105 105 105
0004 105 105 105 0003 058 055 074 1285 025 025 112 0003 044 041 056 0005 105 105 105
0004 105 105 105 0003 058 055 074 1285 025 025 112 0003 044 041 056 0005 105 105 105
0004 105 105 105 0003 058 055 074 1285 025 025 112 0003 044 041 056 0005 105 105 105
0004 105 105 105 0003 058 055 074 1285 025 025 112 0003 044 041 056 0005 105 105 105
0004 105 105 105 0003 058 055 074 1285 025 025 112 0003 044 041 056 0005 105 105 105
0004 105 105 105 0003 058 055 074 1285 025 025 112 0003 044 041 056 0005 105 105 105
0004 105 105 105 0003 058 055 074 1285 025 025 112 0003 044 041 056 0005 105 105 105
0004 105 105 105 0003 058 055 074 1285 025 025 112 0003 044 041 056 0005 105 105 105
0004 105 105 105 0003 058 055 074 1285 025 025 112 0003 044 041 056 0005 105 105 105
0004 105 105 105 0003 058 055 074 1285 025 025 112 0003 044 041 056 0005 105 105 105
0004 105 105 105 0003 058 055 074 1285 025 025 112 0003 044 041 056 0005 105 105 105
0004 105 105 105 0003 058 055 074 1285 025 025 112 0003 044 041 056 0005 105 105 105
0004 105 105 105 0003 058 055 074 1285 025 025 112 0003 044 041 056 0005 105 105 105
0004 105 105 105 0003 058 055 074 1285 025 025 112 0003 044 041 056 0005 105 105 105
0004 105 105 105 0003 058 055 074 1285 025 025 112 0003 044 041 056 0005 105 105 105
0004 105 105 105 0003 058 055 074 1285 025 025 112 0003 044 041 056 0005 105 105 105
0004 105 105 105 0003 058 055 074 1285 025 025 112 0003 044 041 056 0005 105 105 105
0004 105 105 105 0003 058 055 074 1285 025 025 112 0003 044 041 056 0005 105 105 105
0004 105 105 105 0003 058 055 074 1285 025 025 112 0003 044 041 056 0005 105 105 105
0004 105 105 105 0003 058 055 074 1285 025 025 112 0003 044 041 056 0005 105 105 105
0004 105 105 105 0003 058 055 074 1285 025 025 112 0003 044 041 056 0005 105 105 105
0004 105 105 105 0003 058 055 074 1285 025 025 112 0003 044 041 056 0005 105 105 105
0004 105 105 105 0003 058 055 074 1285 025 025 112 0003 044 041 056 0005 105 105 105
0004 105 105 105 0003 058 055 074 1285 025 025 112 0003 044 041 056 0005 105 105 105
0004 105 105 105 0003 058 055 074 1285 025 025 112 0003 044 041 056 0005 105 105 105
0004 105 105 105 0003 058 055 074 1285 025 025 112 0003 044 041 056 0005 105 105 105
0004 105 105 105 0003 058 055 074 1285 025 025 112 0003 044 041 056 0005 105 105 105
0004 105 105 105 0003 058 055 074 1285 025 025 112 0003 044 041 056 0005 105 105 105
0004 105 105 105 0003 058 055 074 1285 025 025 112 0003 044 041 056 0005 105 105 105
0004 105 105 105 0003 058 055 074 1285 025 025 112 0003 044 041 056 0005 105 105 105
0004 105 105 105 0003 058 055 074 1285 025 025 112 0003 044 041 056 0005 105 105 105
0004 105 105 105 0003 058 055 074 1285 025 025 112 0003 044 041 056 0005 105 105 105
0004 105 105 105 0003 058 055 074 1285 025 025 112 0003 044 041 056 0005 105 105 105
0004 105 105 105 0003 058 055 074 1285 025 025 112 0003 044 041 056 0005 105 105 105
0004 105 105 105 0003 058 055 074 1285 025 025 112 0003 044 041 056 0005 105 105 105
0004 105 105 105 0003 058 055 074 1285 025 025 112 0003 044 041 056 0005 105 105 105
0004 105 105 105 0003 058 055 074 1285 025 025 112 0003 044 041 056 0005 105 105 105
0004 105 105 105 0003 058 055 074 1285 025 025 112 0003 044 041 056 0005 105 105 105
0004 105 105 105 0003 058 055 074 1285 025 025 112 0003 044 041 056 0005 105 105 105
0004 105 105 105 0003 058 055 074 1285 025 025 112 0003 044 041 056 0005 105 105 105
0004 105 105 105 0003 058 055 074 1285 025 025 112 0003 044 041 056 0005 105 105 105
0004 105 105 105 0003 058 055 074 1285 025 025 112 0003 044 041 056 0005 105 105 105
0004 105 105 105 0003 058 055 074 1285 025 025 112 0003 044 041 056 0005 105 105 105
0004 105 105 105 0003 058 055 074 1285 025 025 112 0003 044 041 056 0005 105 105 105
0004 105 105 105 0003 058 055 074 1285 025 025 112 0003 044 041 056 0005 105 105 105
0004 105 105 105 0003 058 055 074 1285 025 025 112 0003 044 041 056 0005 105 105 105
0004 105 105 105 0003 058 055 074 1285 025 025 112 0003 044 041 056 0005 105 105 105
0004 105 105 105 0003 058 055 074 1285 025 025 112 0003 044 041 056 0005 105 105 105
0004 105 105 105 0003 058 055 074 1285 025 025 112 0003 044 041 056 0005 105 105 105
0004 105 105 105 0003 058 055 074 1285 025 025 112 0003 044 041 056 0005 105 105 105
0004 105 105 105 0003 058 055 074 1285 025 025 112 0003 044 041 056 0005 105 105 105
0004 105 105 105 0003 058 055 074 1285 025 025 112 0003 044 041 056 0005 105 105 105
0004 105 105 105 0003 058 055 074 1285 025 025 112 0003 044 041 056 0005 105 105 105
0004 105 105 105 0003 058 055 074 1285 025 025 112 0003 044 041 056 0005 105 105 105
0004 105 105 105 0003 058 055 074 1285 025 025 112 0003 044 041 056 0005 105 105 105
0004 105 105 105 0003 058 055 074 1285 025 025 112 0003 044 041 056 0005 105 105 105
0004 105 105 105 0003 058 055 074 1285 025 025 112 0003 044 041 056 0005 105 105 105
0004 105 105 105 0003 058 055 074 1285 025 025 112 0003 044 041 056 0005 105 105 105
0004 105 105 105 0003 058 055 074 1285 025 025 112 0003 044 041 056 0005 105 105 105
0004 105 105 105 0003 058 055 074 1285 025 025 112 0003 044 041 056 0005 105 105 105
0004 105 105 105 0003 058 055 074 1285 025 025 112 0003 044 041 056 0005 105 105 105
0004 105 105 105 0003 058 055 074 1285 025 025 112 0003 044 041 056 0005 105 105 105
0004 105 105 105 0003 058 055 074 1285 025 025 112 0003 044 041 056 0005 105 105 105
0004 105 105 105 0003 058 055 074 1285 025 025 112 0003 044 041 056 0005 105 105 105
0004 105 105 105 0003 058 055 074 1285 025 025 112 0003 044 041 056 0005 105 105 105
0004 105 105 105 0003 058 055 074 1285 025 025 112 0003 044 041 056 0005 105 105 105
0004 105 105 105 0003 058 055 074 1285 025 025 112 0003 044 041 056 0005 105 105 105
0004 105 105 105 0003 058 055 074 1285 025 025 112 0003 044 041 056 0005 105 105 105
0004 105 105 105 0003 058 055 074 1285 025 025 112 0003 044 041 056 0005 105 105 105
0004 105 105 105 0003 058 055 074 1285 025 025 112 0003 044 041 056 0005 105 105 105
0004 105 105 105 0003 058 055 074 1285 025 025 112 0003 044 041 056 0005 105 105 105
0004 105 105 105 0003 058 055 074 1285 025 025 112 0003 044 041 056 0005 105 105 105
0004 105 105 105 0003 058 055 074 1285 025 025 112 0003 044 041 056 0005 105 105 105
0004 105 105 105 0003 058 055 074 1285 025 025 112 0003 044 041 056 0005 105 105 105
0004 105 105 105 0003 058 055 074 1285 025 025 112 0003 044 041 056 0005 105 105 105
0004 105 105 105 0003 058 055 074 1285 025 025 112 0003 044 041 056 0005 105 105 105
0004 105 105 105 0003 058 055 074 1285 025 025 112 0003 044 041 056 0005 105 105 105
0004 105 105 105 0003 058 055 074 1285 025 025 112 0003 044 041 056 0005 105 105 105
0004 105 105 105 0003 058 055 074 1285 025 025 112 0003 044 041 056 0005 105 105 105
0004 105 105 105 0003 058 055 074 1285 025 025 112 0003 044 041 056 0005 105 105 105
0004 105 105 105 0003 058 055 074 1285 025 025 112 0003 044 041 056 0005 105 105 105
0004 105 105 105 0003 058 055 074 1285 025 025 112 0003 044 041 056 0005 105 105 105
0004 105 105 105 0003 058 055 074 1285 025 025 112 0003 044 041 056 0005 105 105 105
0004 105 105 105 0003 058 055 074 1285 025 025 112 0003 044 041 056 0005 105 105 105
0004 105 105 105 0003 058 055 074 1285 025 025 112 0003 044 041 056 0005 105 105 105
0004 105 105 105 0003 058 055 074 1285 025 025 112 0003 044 041 056 0005 105 105 105
0004 105 105 105 0003 058 055 074 1285 025 025 112 0003 044 041 056 0005 105 105 105
0004 105 105 105 0003 058 055 074 1285 025 025 112 0003 044 041 056 0005 105 105 105
0004 105 105 105 0003 058 055 074 1285 205 133 063 0003 044 041 056 0005 105 105 105
0004 105 105 105 0003 058 055 074 1285 205 133 063 0003 044 041 056 0005 105 105 105
0004 105 105 105 0003 058 055 074 1285 205 133 063 0003 044 041 056 0005 105 105 105
0004 105 105 105 0003 058 055 074 1285 205 133 063 0003 044 041 056 0005 105 105 105
0004 105 105 105 0003 058 055 074 1285 205 133 063 0003 044 041 056 0005 105 105 105
0004 105 105 105 0003 058 055 074 1285 205 133 063 0003 044 041 056 0005 105 105 105
0004 105 105 105 0003 058 055 074 1285 205 133 063 0003 044 041 056 0005 105 105 105
0004 105 105 105 0003 058 055 074 1285 205 133 063 0003 044 041 056 0005 105 105 105
0004 105 105 105 0003 058 055 074 1285 205 133 063 0003 044 041 056 0005 105 105 105
0004 105 105 105 0003 058 055 074 1285 205 133 063 0003 044 041 056 0005 105 105 105
0004 105 105 105 0003 058 055 074 1285 205 133 063 0003 044 041 056 0005 105 105 105
0004 105 105 105 0003 058 055 074 1285 000 000 128 0003 044 041 056 0005 105 105 105
0004 105 105 105 0003 058 055 074 1285 000 000 128 0003 044 041 056 0005 105 105 105
0004 105 105 105 0003 058 055 074 1285 000 000 128 0003 044 041 056 0005 105 105 105
0004 105 105 105 0003 058 055 074 1285 000 000 128 0003 044 041 056 0005 105 105 105
0004 105 105 105 0003 058 055 074 1285 000 000 128 0003 044 041 056 0005 105 105 105
0004 105 105 105 0003 058 055 074 1285 000 000 128 0003 044 041 056 0005 105 105 105
0004 105 105 105 0003 058 055 074 1285 000 000 128 0003 044 041 056 0005 105 105 105
0004 105 105 105 0003 058 055 074 1285 000 000 128 0003 044 041 056 0005 105 105 105
0004 105 105 105 0003 058 055 074 1285 000 000 128 0003 044 041 056 0005 105 105 105
0004 105 105 105 0003 058 055 074 1285 000 000 128 0003 044 041 056 0005 105 105 105
0004 105 105 105 0003 058 055 074 1285 000 000 128 0003 044 041 056 0005 105 105 105
0004 105 105 105 0003 058 055 074 1285 000 000 128 0003 044 041 056 0005 105 105 105
0004 105 105 105 0003 058 055 074 1285 000 000 128 0003 044 041 056 0005 105 105 105
0004 105 105 105 0003 058 055 074 1285 000 000 128 0003 044 041 056 0005 105 105 105
0004 105 105 105 0003 058 055 074 1285 000 000 128 0003 044 041 056 0005 105 105 105
0004 105 105 105 0003 058 055 074 1285 000 000 128 0003 044 041 056 0005 105 105 105
0004 105 105 105 0003 058 055 074 1285 000 000 128 0003 044 041 056 0005 105 105 105
0004 105 105 105 0003 058 055 074 1285 000 000 128 0003 044 041 056 0005 105 105 105
0004 105 105 105 0003 058 055 074 1285 000 000 128 0003 044 041 056 0005 105 105 105
0004 105 105 105 0003 058 055 074 1285 000 000 128 0003 044 041 056 0005 105 105 105
0004 105 105 105 0003 058 055 074 1285 000 000 128 0003 044 041 056 0005 105 105 105
0004 105 105 105 0003 058 055 074 1285 000 000 128 0003 044 041 056 0005 105 105 105
0004 105 105 105 0003 058 055 074 1285 000 000 128 0003 044 041 056 0005 105 105 105
0004 105 105 105 0003 058 055 074 1285 000 000 128 0003 044 041 056 0005 105 105 105
0004 105 105 105 0003 058 055 074 1285 000 000 128 0003 044 041 056 0005 105 105 105
0004 105 105 105 0003 058 055 074 1285 000 000 128 0003 044 041 056 0005 105 105 105
0004 105 105 105 0003 058 055 074 1285 000 000 128 0003 044 041 056 0005 105 105 105
0004 105 105 105 0003 058 055 074 1285 000 000 128 0003 044 041 056 0005 105 105 105
0004 105 105 105 0003 058 055 074 1285 000 000 128 0003 044 041 056 0005 105 105 105
0004 105 105 105 0003 058 055 074 1285 000 000 128 0003 044 041 056 0005 105 105 105
0004 105 105 105 0003 058 055 074 1285 000 000 128 0003 044 041 056 0005 105 105 105
0004 105 105 105 0003 058 055 074 1285 000 000 128 0003 044 041 056 0005 105 105 105
0004 105 105 105 0003 058 055 074 1285 000 000 128 0003 044 041 056 0005 105 105 105
0004 105 105 105 0003 058 055 074 1285 000 000 128 0003 044 041 056 0005 105 105 105
0004 105 105 105 0003 058 055 074 1285 000 000 128 0003 044 041 056 0005 105 105 105
0004 105 105 105 0003 058 055 074 1285 000 000 128 0003 044 041 056 0005 105 105 105
0004 105 105 105 0003 058 055 074 1285 000 000 128 0003 044 041 056 0005 105 105 105
0004 105 105 105 0003 058 055 074 1285 000 000 128 0003 044 041 056 0005 105 105 105
0004 105 105 105 0003 058 055 074 1285 000 000 128 0003 044 041 056 0005 105 105 105
0004 105 105 105 0003 058 055 074 1285 000 000 128 0003 044 041 056 0005 105 105 105
0004 105 105 105 0003 058 055 074 1285 000 000 128 0003 044 041 056 0005 105 105 105
0004 105 105 105 0003 058 055 074 1285 000 000 128 0003 044 041 056 0005 105 105 105
0004 105 105 105 0003 058 055 074 1285 000 000 128 0003 044 041 056 0005 105 105 105
0004 105 105 105 0003 058 055 074 1285 000 000 128 0003 044 041 056 0005 105 105 105
0004 105 105 105 0003 058 055 074 1285 000 000 128 0003 044 041 056 0005 105 105 105
0004 105 105 105 0003 058 055 074 1285 000 000 128 0003 044 041 056 0005 105 105 105
0004 105 105 105 0003 058 055 074 1285 000 000 128 0003 044 041 056 0005 105 105 105
0004 105 105 105 0003 058 055 074 1285 000 000 128 0003 044 041 056 0005 105 105 105
0004 105 105 105 0003 058 055 074 1285 000 000 128 0003 044 041 056 0005 105 105 105
0004 105 105 105 0003 058 055 074 1285 000 000 128 0003 044 041 056 0005 105 105 105
0004 105 105 105 0003 058 055 074 1285 000 000 128 0003 044 041 056 0005 105 105 105
0004 105 105 105 0003 058 055 074 1285 000 000 128 0003 044 041 056 0005 105 105 105
0004 105 105 105 0003 058 055 074 1285 000 000 128 0003 044 041 056 0005 105 105 105
0004 105 105 105 0003 058 055 074 1285 000 000 128 0003 044 041 056 0005 105 105 105
0004 105 105 105 0003 058 055 074 1285 000 000 128 0003 044 041 056 0005 105 105 105
0004 105 105 105 0003 058 055 074 1285 000 000 128 0003 044 041 056 0005 105 105 105
0004 105 105 105 0003 058 055 074 1285 000 000 128 0003 044 041 056 0005 105 105 105
0004 105 105 105 0003 058 055 074 1285 000 000 128 0003 044 041 056 0005 105 105 105
0004 105 105 105 0003 058 055 074 1285 000 000 128 0003 044 041 056 0005 105 105 105
0004 105 105 105 0003 058 055 074 1285 000 000 128 0003 044 041 056 0005 105 105 105
0004 105 105 105 1291 058 055 074 0005 105 105 105
1300 105 105 105
1300 105 105 105
0004 105 105 105 1290 000 000 000 0006 105 105 105
0004 105 105 105 1290 000 000 000 0006 105 105 105
0004 105 105 105 1290 000 000 000 0006 105 105 105
0004 105 105 105 1290 000 000 000 0006 105 105 105
0004 105 105 105 1290 000 000 000 0006 105 105 105
0004 105 105 105 1290 000 000 000 0006 105 105 105
0004 105 105 105 1290 000 000 000 0006 105 105 105
0004 105 105 105 1290 000 000 000 0006 105 105 105
1300 105 105 105
1300 105 105 105
