400 52
................................................................................................................................................................................................................................................................................................................................................................................................................
................................................................................................................................................................................................................................................................................................................................................................................................................
................................................................................................................................................................................................................................................................................................................................................................................................................
................................................................................................................................................................................................................................................................................................................................................................................................................
................................................................................................................................................................................................................................................................................................................................................................................................................
................................................................................................................................................................................................................................................................................................................................................................................................................
................................................................................................................................................................................................................................................................................................................................................................................................................
................................................................................................................................................................................................................................................................................................................................................................................................................
................................................................................................................................................................................................................................................................................................................................................................................................................
................................................................................................................................................................................................................................................................................................................................................................................................................
................................................................................................................................................................................................................................................................................................................................................................................................................
................................................................................................................................................................................................................................................................................................................................................................................................................
................................................................................................................................................................................................................................................................................................................................................................................................................
................................................................................................................................................................................................................................................................................................................................................................................................................
................................................................................................................................................................................................................................................................................................................................................................................................................
................................................................................................................................................................................................................................................................................................................................................................................................................
................................................................................................................................................................................................................................................................................................................................................................................................................
........................................................................................................................................66666..............................................................................................................6666.................................................................................................................................................
.....................................................................................................................................66666666666........................................................................................................6666666666..............................................................................................................................................
..................................................................................................................................666666666666666666................................................................................................666666666666666666..........................................................................................................................................
..............................................................................................................................6666666666666666666666666..........................................................................................666666666666666666666666.......................................................................................................................................
..........................................................................................................................6666666666666666666666666666666666.................................................................................666666666666666666666666666666666..................................................................................................................................
......................................................................................................................666666666666666666666666666666666666666666.........................................................................66666666666666666666666666666666666666666..............................................................................................................................
..................................................................66666..........................................666666666666666666666666....66666666666666666666666666.............................................................6666666666666666666666666.66666666666666666666666666..........................................66666.........................................................................
...............................................................6666666666....................................666666666666666666666666...........666666666666666666666666666......................................................66666666666666666666666..........666666666666666666666666666..................................6666666666.......................................................................
...........................................................66666666666666666...........................66666666666666666666666.........................6666666666666666666666666666........................................66666666666666666666666......................66666666666666666666666666666......................666666666666666666...................................................................
........................................................666666666666666666666666...................6666666666666666666666...................................666666666666666666666666666...............................6666666666666666666666..................................666666666666666666666666666...............66666666666666666666666.................................................................
....................................................66666666666666666666666666666666..........66666666666666666...........................................................6666666666666......6666666.............666666666666666666.......................................................666666666666666...........66666666666666666666666666666666............................................................
.................................................666666666666666666666666666666666666666......66666666....................................................................................666666666666..........666666666666.....................................................................................66666666666666666666666666666666666666.........................................................
.............................................666666666666666666666666666666666666666666666666..........................................................................................6666666666666666666...................................................................................................666666666666666666666666666666666666666666666666...................................................
.........................................66666666666666666666666666666666666666666666666666666666..................................................................................66666666666666666666666666............................................................................................66666666666666666666666666666666666666666666666666666666...............................................
....................................666666666666666666666666666666....666666666666666666666666666666666.........................................................................666666666666666666666666666666666....................................................................................66666666666666666666666666666.....66666666666666666666666666666666.........................................
................................666666666666666666666666666666............6666666666666666666666666666666666................................................................6666666666666666666666666666666666666666............................................................................666666666666666666666666666666.............666666666666666666666666666666666....................................
...........................66666666666666666666666666666........................6666666666666666666666666666666666.......................................................66666666666666666666666666666666666666666666666...................................................................6666666666666666666666666666.........................66666666666666666666666666666666666.............................
......................6666666666666666666666666666....................................66666666666666666666666666666666666............................................66666666666666666666666666666666666666666666666666666666.........................................................6666666666666666666666666666....................................66666666666666666666666666666666666.......................
................66666666666666666666666666....................................................666666666666666666666666666666666..................................666666666666666666666666666666666666666666666666666666666666666.................................................66666666666666666666666666...................................................666666666666666666666666666666666.................
...........666666666666666666666666....................................................................66666666666666666666666666............................6666666666666666666666666666666666666666666666666666666666666666666666666.....................................666666666666666666666666.....................................................................6666666666666666666666666...............
.......6666666666666666666...............................................................................................................................66666666666666666666666666666666666666....6666666666666666666666666666666666666666...........................666666666666666666666.....................................................................................................................
.......666666.......................................................................................................................................66666666666666666666666666666666666666.............66666666666666666666666666666666666666666......................6666666...................................................................................................................................
.................................................................................................................................................666666666666666666666666666666666666.......................666666666666666666666666666666666666666666..........................................................................................................................................................
...........................................................................................................................................666666666666666666666666666666666666...................................666666666666666666666666666666666666666666....................................................................................................................................................
......................................................................................................................................666666666666666666666666666666666666.............................................6666666666666666666666666666666666666666666..............................................................................................................................................
.................................................................................................................................66666666666666666666666666666666...............................................................66666666666666666666666666666666666666666.......................................................................................................................................
............................................................................................................................66666666666666666666666666666666...........................................................................666666666666666666666666666666666666666666...............................................................................................................................
......................................................................................................................666666666666666666666666666...................................................................................................666666666666666666666666666666..............................................................................................................................
...............................................................................................................666666666666666666666666666............................................................................................................................6666666...................................................................................................................................
.............................................................................................................666666666666666....................................................................................................................................................................................................................................................................................
................................................................................................................................................................................................................................................................................................................................................................................................................
................................................................................................................................................................................................................................................................................................................................................................................................................
................................................................................................................................................................................................................................................................................................................................................................................................................
................................................................................................................................................................................................................................................................................................................................................................................................................
................................................................................................................................................................................................................................................................................................................................................................................................................

